111111111111111111111
1C0000CCCC000E00000C1
100010100000P001C0011
10001
111111111111111111111