1111111
1P1C0C1
1001001
101E101
1111111